子蹇=Tử Kiển
郎光耀=Lang Quang Diệu
周淑琪=Chu Thục Kỳ
纪伯伦=Gibran
周志峰=Chu Chí Phong
安乐乐=An Nhạc Nhạc
小钟=Tiểu Chung
穆星雨=Mục Tinh Vũ
虞清=Ngu Thanh
刘丧=Lưu Tang
维杰=Duy Kiệt
永生科技=Công ty Công nghệ Aeon
八角巷=hẻm Bát Giác
白卿卿=Bạch Khanh Khanh
周允晟=Chu Doãn Thịnh
沈友全=Thẩm Hữu Toàn
莱茵多特=Rhinedottir
高小白=Cao Tiểu Bạch
小织=Tiểu Chức
古华=Guhua/Cổ Hoa
仙众夜叉=Tiên chúng Dạ xoa
杜佳骏=Đỗ Giai Tuấn
西山=Tây Sơn
青训=Thanh Huấn
薄沁妍=Bạc Thấm Nghiên
天衡=Thiên Hoành
伊曼=Iman
周洪宇=Chu Hồng Vũ
爆狙老攻之后=Sau khi bắn tỉa headshot lão công/Bạo thư lão công chi hậu
雨珊=Vũ San
伊顿=Eaton
瀚噶族=tộc Hãn Cát 
知衍=Tri Diễn
薛阳=Tiết Dương
劳伦斯=Lawrence
王盟=Vương Minh
施瓦本=Schwäbische
河童=Hà Đồng
红毛春=Xuân Tóc Đỏ
希尔希纳=Sirshana
喻敛=Dụ Liễm
屈泽=Khuất Trạch
李岚=Lý Lam
阿育王=A Dục vương
孟子晴=Mạnh Tử Tinh
李力=Lý Lực
小辞=Tiểu Từ
梁飞=Lương Phi
哈布娜=Habunah
新城=Tân Thành
成雪=Thành Tuyết
若鸯君=Nhược Ương Quân
周京明=Chu Kinh Minh
大庆=Đại Khánh
萨达尔尼=Sadani
丽兹波顿=Lizzie
林念慈=Lâm Niệm Từ
左弦=Tả Huyền
明鉴表=Đồng hồ Minh Giám/Minh Giám Biểu
鲁梅拉=Lumera
小佘=Tiểu Xa
布莱克斯=Blacks
沈深=Thẩm Thâm
敏芝=Mẫn Chi
俞小仓=Du Tiểu Thương
小丽=Tiểu Lệ
安洁莉娜=Angelina
多啦 A 梦=Doraemon
观落阴=Quan Lạc Âm
轩何志=Hiên Hà Chí
明清=Minh Thanh
小丹丹=Tiểu Đan Đan
烛九=Chúc Cửu
宋景=Tống Cảnh
廖珊=Liêu San
顾景深=Cố Cảnh Thâm
常净=Thường Tịnh
薛珂=Tiết Kha
思雨=Tư Vũ
孙山刚=Tôn Sơn Cương
董杰=Đổng Kiệt
文彦=Văn Ngạn
邱浩=Khâu Hạo
宝融=Bảo Dung
王胖子=Vương Bàn Tử
萨姆=Sam
橙子雨=Chanh Tử Vũ
晟晟=Thành Thành
灵异小熊猫=Gấu Trúc Nhỏ Thần Bí
殷扬=Ân Dương
冰之女皇=Tsaritsa/Nữ hoàng Băng
周平=Chu Bình
小李=Tiểu Lý
乐不听=Nhạc Bất Thính
西凤=Tây Phượng
克里斯多夫=Christopher
饶饶=Nhiêu Nhiêu
泰康=Thái Khang
派克=Peck
高琳琳=Cao Lâm Lâm
傅勇=Phó Dũng
阿斯曼=Asman
阿巴莱茵=Abberline
天水宫=cung Thiên Thủy 
君怡=Quân Di
崔炎=Thôi Viêm
阿育王寺=A Dục Vương tự
何疏漠=Hà Sơ Mạc
小温=Tiểu Ôn
薛扬=Tiết Dương
海市=thành phố Hải
阿雷克斯=Alexis
黎未都=Lê Vị Đô
薛夏=Tiết Hạ
小粉=Tiểu Phấn
杜莎莎=Đỗ Toa Toa
任风飞=Nhậm Phong Phi
先贤=Tiên Hiền
罗导=La Đạo
兴业=Hưng Nghiệp
亚男=Á Nam
马特=Matt
神子=Miko
辛巴=Tân Ba
张芳翠=Trương Phương Thúy
小艾=Tiểu Ngải
巴鲁托=Baldroy
千岩军=Thiên Nham quân
弗吉=Foggy
钱小森=Tiền Tiểu Sâm
程浴血=Trình Dục Huyết
水幕=Thủy Mạc
陈朗=Trần Lãng
段易=Đoàn Dịch
谭晟=Đàm Thành
黄小波=Hoàng Tiểu Ba
南宫=Nam Cung
毛小明=Mao Tiểu Minh
绿河=Lục Hà
亚瑟=Arthur
佟凯=Đông Khải
临山水阁=lầu Lâm Sơn Thuỷ
段小舟=Đoàn Tiểu Chu
刘赫=Lưu Hách
天真=Thiên Chân
诺克斯=Knox
小天和=Tiểu Thiên Hòa
柯锐=Kha Nhuệ
蒙克=Mon Kram
厄桂岭=núi Ách Quế
田鸣=Điền Minh
飞飞=Phi Phi
楚叙=Sở Tự
普契涅拉=Pulcinella
吴舜=Ngô Thuấn
朱白=Chu Bạch
永泰=Vĩnh Thái
乔安妮=Joanne
维齐尔=vizier
阮珠江=Nguyễn Châu Giang
砂糖=Sucrose
沈途=Thẩm Đồ
路北然=Lộ Bắc Nhiên
秀秀=Tú Tú
穆泽=Mục Trạch
苏亦=Tô Diệc
和合二仙=Hòa Hợp Nhị Tiên
朴俊英=Phác Tuấn Anh
古蜀=Cổ Thục
阿豪=A Hào
七浦=Thất Phổ
阿淼=A Miểu
高翠兰=Cao Thúy Lan
哲巴尔=Jabal
方虎=Phương Hổ
莱斯特=Lester
林正=Lâm Chính
路羽=Lộ Vũ
黄三虎=Hoàng Tam Hổ
金光咒=chú Kim Quang
宋关=Tống Quan
肖云=Tiêu Vân
炎之魔女=Diệm Liệt Ma Nữ
柯雷=Köhler
小凌=Tiểu Lăng
黄大羊=Hoàng Đại Dương
吕兰兰=Lữ Lan Lan
古斯塔夫=Gustav
玲娜贝儿=LinaBell
青乌=Thanh Ô
碧桂园=vườn Bích Quế
孔奕林=Khổng Dịch Lâm
江琛=Giang Sâm
孟仲=Mạnh Trọng
撒野=Tát Dã
雷霆=Lôi Đình
吕岱=Lữ Đại
大明金刚咒= chú Đại Minh Kim Cương
艾克斯=Aix
小杨=Tiểu Dương
香江集团=tập đoàn Hồng Kông/Heung Kong Group Limited
赵国安=Triệu Quốc An
崔恩=Thôi Ân
颜晓晓=Nhan Hiểu Hiểu
邵卓=Thiệu Trác
小方=Tiểu Phương
亚太=Á Thái
哈科特=Harcourt
墨轩=Mặc Hiên
滕庆华=Đằng Khánh Hoa
温煦=Ôn Húc
谢怀=Tạ Hoài
蓝羽鸟=Lam Vũ điểu
哑巴张=Trương câm
魏多=Ngụy Đa
尼诺斯=Ninus
梵凯旭=Phạn Khải Húc
曾可儿=Tằng Khả Nhi
陈国旗=Trần Quốc Kỳ
神里绫华=Kamisato Ayaka
珞瑜=Lạc Du
大老鱼=Đại Lão Ngư
楸叶=Thu Diệp
莫里斯=Morris
关越=Quan Việt
宁倩=Ninh Thiến
胡二=Hồ Nhị
言识=Ngôn Thức
食魔李大嘴=Lý Mồm To Ăn Ma Quỷ
林娜=Lâm Na
蒙清=Mon Chadcen
纪锴=Kỷ Khải
晏绍=Yến Thiệu
酆淮=Phong Hoài
聂晓宇=Nhiếp Hiểu Vũ
汉莎=Lufthansa
荒泷一斗=Arataki Itto
黄大发=Hoàng Đại Phát
乌多利=Woodley
云哲=Vân Triết
宋子成=Tống Tử Thành
姜锦=Khương Cẩm
普罗=Prome
陆六少=Lục Lục thiếu
丘家贵=Khâu Gia Quý
黑崎子=Hắc Khi Tử
黄小明=Hoàng Tiểu Minh
丁羽=Đinh Vũ
韩新波=Hàn Tân Ba
小金=Tiểu Kim
顾琛=Cố Sâm
雯雯=Văn Văn
白术=Baizhu/Bạch Truật
爵磊=Tước Lỗi
方路=Phương Lộ
兰德尔=Randall
蒋子文=Tưởng Tử Văn
戚无妄=Thích Vô Vọng
柯蒂利亚=Cordelia/Cortilla
布雷尔=Blair
一辉=Nhất Huy
关圣帝君=Quan Thánh đế quân/Quan Vũ
布柯特=Bucott
丁力波=Đinh Lực Ba
楚酒=Sở Tửu
冥界=Minh giới
周慧=Chu Tuệ
沈维杰=Thẩm Duy Kiệt
纳尔逊=Nelson
卢克群=Lư Khắc Quần
蔺星沉=Lận Tinh Trầm
徐有才=Từ Hữu Tài
内伦=Nelen
飞仙=Phi Tiên
孔昀=Khổng Vân
魏彩蝶=Ngụy Thải Điệp
离岸=Ly Ngạn
周谷成=Chu Cốc Thành
洛尔曼=Lohrman
诺林=Norrin
明月=Minh Nguyệt
迪德里希=Diederich
依凌=Y Lăng
娜依拉=Nayla
张先祯=Trương Tiên Trinh
琳妮特=Lynette
刘韬=Lưu Thao
沈建业=Thẩm Kiến Nghiệp
顾沁=Cố Thấm
林芸=Lâm Vân
富兰克林=Franklin
沈琳=Thẩm Lâm
夜枭=Dạ Kiêu
李长健=Lý Trường Kiện
楚时辞=Sở Thời Từ
倪心海=Nghê Tâm Hải
陆芳朝=Lục Phương Triêu
卫龙=Vệ Long
荣和=Vinh Hòa
多纳兹=Donalds
小扎=Tiểu Trát
君不见=Quân Bất Kiến
温雅=Ôn Nhã
沙利文=Sullivan
风流书呆=Phong Lưu Thư Ngốc
陆雨平=Lục Vũ Bình
麦莎=Mạch Toa
耀晋=Diệu Tấn
韩秀=Hàn Tú
肖雨=Tiêu Vũ
阿拉索=Arasso
正萌=Chính Manh
丘露=Khâu Lộ
曲娴芬=Khúc Nhàn Phân
佳士得=Christie's
云堇=Yunjin/Vân Cận
千盛=Thiên Thịnh
玲娜=Lina
嶓冢=Ba Trủng
张秋=Trương Thu
卡尔=Carl
洛云松=Lạc Vân Tùng
冯嵩=Phùng Tung
方闻言=Phương Văn Ngôn
暮成雪=Mộ Thành Tuyết
小牧=Tiểu Mục
桐花中=Đồng Hoa Trung
李丘=Lý Khâu
王思雅=Vương Tư Nhã
白月=Bạch Nguyệt
林杨=Lâm Dương
北井=Kitai
安保嘉=An Bảo Gia
汪小风=Uông Tiểu Phong
武朝=Vũ Triều
西门子=Siemens
张宇铭=Trương Vũ Minh
苏枫溪=Tô Phong Khê
赵长庚=Triệu Trường Canh
赵胜男=Triệu Thắng Nam
周永飞=Chu Vĩnh Phi
蔡文强=Thái Văn Cường
夏夏=Hạ Hạ
金总冠=Kim Tổng Quan
莎姬=Zazie
钱曲文=Tiền Khúc Văn
萧言翎=Tiêu Ngôn Linh
小郭=Tiểu Quách
塞松=Cesson
沈连哲=Thẩm Liên Triết
魏杰修=Ngụy Kiệt Tu
格雷顿=Creyton
临江=Lâm Giang
董和=Đổng Hòa
王露=Vương Lộ
章利兰=Chương Lợi Lan
阿辞=A Từ
小琦=Tiểu Kỳ
秦浩=Tần Hạo
周振安=Chu Chấn An
翟思铭=Địch Tư Minh
哲彦=Triết Ngạn
晚晚=Vãn Vãn
大伟=Đại Vĩ
凌寒=Lăng Hàn
香菱=Xiangling/Hương Lăng
小雷=Tiểu Lôi
方黎=Phương Lê
纪宁=Kỷ Ninh
肖宏伟=Tiêu Hồng Vĩ
银泰=Ngân Thái
梅姬=Meggie
晚宁=Vãn Ninh
姜昀汶=Khương Quân Vấn
刻晴=Keqing/Khắc Tinh
城南=Thành Nam
无情阁=Vô Tình các
高芊芊=Cao Thiên Thiên
娜娜子=Nanako
石永浩=Thạch Vĩnh Hạo
顾厌=Cố Yếm
叶旭=Diệp Húc
竹真真=Trúc Chân Chân
顾元白=Cố Nguyên Bạch
杰瑞德=Jared
毕先生=Tất Tiên Sinh
龙图=Long Đồ
黄二狗=Hoàng Nhị Cẩu
独目小僧=Hitosume-kozo
小驴=Tiểu Lư
吴灯=Ngô Đăng
希闻=Hy Văn
魈=Xiao/Tiêu
董晴=Đổng Tình
夏尔=Ciel
袁少春=Viên Thiếu Xuân
伽罗=Già La
依安=Y An
克劳斯=Klaus
天和=Thiên Hòa
小胡=Tiểu Hồ
托马=Thoma
白止=Bạch Chỉ
七七=Qiqi/Thất Thất
树树=Thụ Thụ
叶龙=Diệp Long
刘晓旺=Lưu Hiểu Vượng
扫地阁=Tảo Địa các
恩雅=Enya
红星=Hồng Tinh
皓玥=Hạo Nguyệt
沃尔夫拉姆=Wolfram
沈书=Thẩm Thư
叫唤大地狱=Khiếu Hoán Đại Địa Ngục
雪狼王=Vua Sói Tuyết
布朗=Brown
貞素=Trinh Tố
谢邀=Tạ Yêu
无为子=Vô Vi Tử
方瑜=Phương Du
梦溪石=Mộng Khê Thạch
潘大伟=Phan Đại Vĩ
钟应=Chung Ứng
关正平=Quan Chính Bình
楚莫邪=Sở Mạc Tà
弗瑞德=Fred
林建=Lâm Kiến
京郊=Kinh Giao
沈卓礼=Thẩm Trác Lễ
宋温暖=Tống Ôn Noãn
陵夷=Lăng Di
王建强=Vương Kiến Cường
吴二白=Ngô Nhị Bạch
小吴=Tiểu Ngô
小罗=Tiểu La
翟厌=Địch Yếm
安利君=An Lợi Quân
秋秋=Thu Thu
江浔川=Giang Tầm Xuyên
江林=Giang Lâm
尚晓佳=Thượng Hiểu Giai
思洛=Tư Lạc
汤芸芸=Thang Vân Vân
陈大鑫=Trần Đại Hâm
里尔克=Rilke
星辉=Tinh Huy
沈知古=Thẩm Tri Cổ
临省=tỉnh Lâm
弇山=Yểm Sơn
雪豹族=tộc Báo Tuyết
云星=Vân Tinh
闻天岳=Văn Thiên Nhạc
丁浦航=Đinh Phố Hàng
江岳=Giang Nhạc
镜像之城=Parallel City
艾蜜莉=Emily
黑风山寨老妖=Lão yêu sơn trại Hắc Phong
大为=David
平蔵=Heizou
阎王鞭=Diêm Vương Tiên
枫丹=Fountain
苏珞瑜=Tô Lạc Du
亚述=Assyria
蒙阿育塔雅=Mon Ayutthaya
长江=Trường Giang
红叶=Hồng Diệp
厉温=Lệ Ôn
白恩=Bạch Ân
谢茂=Tạ Mậu
寿盘=Thọ Bàn
王云龙=Vương Vân Long
苏槐=Tô Hòe
韩一峥=Hàn Nhất Tranh
奴良家主=Nura gia chủ
何静莲=Hà Tịnh Liên
梵洛山=Phạn Lạc Sơn
叶诚=Diệp Thành
容名媛=Dung Danh Viện
袁平=Viên Bình
徐仲瑶=Từ Trọng Dao
余海先=Dư Hải Tiên
小闻=Tiểu Văn
须弥=Sumeru
斯坦福=Stanford
冈村贤之助=Okamura Kenosuke
老九门=Lão Cửu Môn
铜钱龛世=Đồng Tiền Kham Thế
周娅=Chu Á
阿迪莱=Adila
乔诗雨=Kiều Thi Vũ
简雅=Giản Nhã
三无 Marblue=Tam Vô Marblue
尼奥特=Neot
芬克=Fink/Funk
盘龙=Bàn Long
于光=Vu Quang
程如山=Trình Như Sơn
雷蒙=Raymond
季眠=Quý Miên
丁小红=Đinh Tiểu Hồng
孙正气=Tôn Chính Khí
徐才=Từ Tài
马国庆=Mã Quốc Khánh
小泽=Tiểu Trạch
雷泽=Razor
蒋章=Tưởng Chương
念恩=Niệm Ân
陈颖=Trần Dĩnh
霍道夫=Hoắc Đạo Phu
章茵绮=Chương Nhân Ỷ
丽丽=Lệ Lệ
小言=Tiểu Ngôn
许艺洋=Hứa Nghệ Dương
加达尔=Kadar
俄罗斯方块=Tetris
万诗舒=Vạn Thi Thư
李猛=Lý Mãnh
王畹=Vương Uyển
九条裟罗=Kujou Sara
李迨勋=Lý Đãi Huân
小谭=Tiểu Đàm
奥德=Ode
宛媛=Uyển Viện
韩九立=Hàn Cửu Lập
柏兰特=Brandt
周从=Chu Tòng
小帕=Tiểu Mạt
南山派=phái Nam Sơn
未来娱乐=Giải trí Tương Lai
阿尔克=Arques
小广=Tiểu Quảng
王莹莹=Vương Oánh Oánh
齐格林德=Sieglinde
格林菲=Greenfil
柒冉=Thất Nhiễm
魏文轩=Ngụy Văn Hiên
宋智行=Tống Trí Hành
小水=Tiểu Thủy
林希=Lâm Hy
安柏=Amber
武羿=Vũ Nghệ
奈费勒=Nawfal
史蒂文=Steven
菲谢尔=Fischl
康雄=Khang Hùng
恩慈=Ân Từ
念慈=Niệm Từ
谭遵=Đàm Tuân
钱良功=Tiền Lương Công
陆兴国=Lục Hưng Quốc
柳椒=Liễu Tiêu
滑瓢=Nurarihyon
姚木林=Diêu Mộc Lâm
陆毅凯=Lục Nghị Khải
小夏=Tiểu Hạ
灵灵=Linh Linh
溪年=Khê Niên
巴特立克=Patrick
伊蒙洛卡一=Imunlaukr
渝小鱼=Du Tiểu Ngư
马国容=Mã Quốc Dung
宋恩慈=Tống Ân Từ
绍祥=Thiệu Tường
江曼=Giang Mạn
薛白=Tiết Bạch
许梨=Hứa Lê
阎泉陵=Diêm Tuyền Lăng
胡光伟=Hồ Quang Vĩ
顾良=Cố Lương
林严肃=Lâm Nghiêm Túc
明达尔=Mindal
邱晨=Khâu Thần
阮叶=Nguyễn Diệp
张阳=Trương Dương
褚神=Chử thần
袁先生总是不开心=Viên Tiên Sinh Luôn Không Vui
菲普斯=Phipps
秦译=Tần Dịch
王芳舒=Vương Phương Thư
路天和=Lộ Thiên Hòa
阡阡=Thiên Thiên
派蒙=Paimon
沈玉饶=Thẩm Ngọc Nhiêu
于年=Vu Niên
大宛=Đại Uyên
江淼=Giang Miểu
小陆=Tiểu Lục
胡北嘉=Hồ Bắc Gia
芳华=Phương Hoa
沅陵县=huyện Nguyên Lăng
小阿识=Tiểu A Thức
童灵谣=Đồng Linh dao
辛焱=Xinyan/Tân Diễm
瑞秋=Rachel
思铭=Tư Minh
宋贝妮=Tống Bối Ny
仁德=Nhân Đức
奥尔良=Orleans
小柳=Tiểu Liễu
留吉=Ruji
胡雯雯=Hồ Văn Văn
小孙=Tiểu Tôn
帕拉图=Palato
居鲁士=Cyrus
马国明=Mã Quốc Minh
锡兰=Ceylon
闻元恺=Văn Nguyên Khải
嘉莉=Gia Lỵ
阿贝多=Albedo
蒙德=Mondstadt
李茉莉=Lý Mạt Lị
艾莉丝=Alice
秋石=Thu Thạch
风子煙=Phong Tử Yên
秦安=Tần An
芳芳=Phương Phương
方宜兰=Phương Nghi Lan
郑益民=Trịnh Ích Dân
林钦=Lâm Khâm
弘一=Hoằng Nhất
曾国豪=Tằng Quốc Hào
钟晟=Chung Thịnh
斯基泰=Scyth
严适=Nghiêm Thích
横市=thành phố Hoành
周宛媛=Chu Uyển Viện
志明=Chí Minh
池云星=Trì Vân Tinh
小张=Tiểu Trương
夏娃=Eve
腾龙=Đằng Long
云天=Vân Thiên
达达利亚=Tartaglia
奥尔罗=Orro
秦淮舟=Tần Hoài Chu
江潮生=Giang Triều Sinh
沈北=Thẩm Bắc
林鹏=Lâm Bằng
克劳迪娅=Claudia
魔镜=Ma kính
王月半=Vương Nguyệt Bán
蒋勋=Tưởng Huân
蔓藤=Mạn Đằng
关正瀚=Quan Chính Hãn
正平=Chính Bình
耶梦=Gia Mộng
卓一隆=Trác Nhất Long
张小凡=Trương Tiểu Phàm
江铃=Giang Linh
楚门=Truman
迟小多=Trì Tiểu Đa
季灵渠=Quý Linh Cừ
康斯坦利=Constance
静安路=đường Tịnh An
王伟=Vương Vĩ
尤七=Vưu Thất
卢梦梦=Lư Mộng Mộng
埃瑞克=Erik
积家=Jaeger
铜雀=Đồng Tước/Pervases
食尸老祖=Thực Thi Lão Tổ
知星=Tri Tinh
小北=Tiểu Bắc
高尔=Cole
秦婉婉=Tần Uyển Uyển
姜亮=Khương Lượng
梁非力=Lương Phi Lực
罗纳德=Ronald
小关=Tiểu Quan
萝卜花兔子=La Bặc Hoa Thố Tử
凯瑟琳=Katheryne
丹丹=Đan Đan
小孔=Tiểu Khổng
石四珏=Thạch Tứ Giác
杰克曼=Jackman
凌昭侠=Lăng Chiêu Hiệp
奴良=Nurarihyon
傅七七=Phó Thất Thất
帕金森=Parkinson 
康莱德=Conrad
林燕淳=Lâm Yến Thuần
陈戈=Trần Qua
老鲍=lão Bảo
女百长=Nữ Bách Trường
黄小蛋=Hoàng Tiểu Đản
木糖=Mộc Đường
高士杰=Cao Sĩ Kiệt
慧慧=Tuệ Tuệ
刘琦=Lưu Kỳ
徐琮璋=Từ Tông Chương
仲孙昊=Trọng Tôn Hạo
闷油瓶=Muộn Du Bình/bình kín miệng
留雲借風真君=Lưu Vân Tá Phong chân quân
漆明=Tất Minh
巴特=Bart
沈睿=Thẩm Duệ
邱婉=Khâu Uyển
朴丽玉=Phác Lệ Ngọc
伐难=Phạt Nan/Bonanus
罗小黑战记=La Tiểu Hắc chiến ký
晋市=Tấn thị/thành phố Tấn
叶秋桐=Diệp Thu Đồng
顾云哲=Cố Vân Triết
提灯看刺刀=Đốt Đèn Nhìn Lưỡi Đao
翟思洛=Địch Tư Lạc
幽畜=U Súc
苏哲彦=Tô Triết Ngạn
墨玖=Mặc Cửu
珊瑚宮=Sangonomiya
叶南=Diệp Nam
刘然=Lưu Nhiên
徐正芳=Từ Chính Phương
罗伦斯=Lawrence
修音师=Tu Âm Sư
至冬=Snezhnaya
阿育塔雅=Ayutthaya/อยุธยา
小雨=Tiểu Vũ
李丽=Lý Lệ
小章=Tiểu Chương
阮南烛=Nguyễn Nam Chúc
法德耶=Fadia
主脑=Máy chủ
小叶=Tiểu Diệp
魂斗罗=Contra
岩王帝君=Nham vương Đế quân
王溯=Vương Tố
汪徵=Uông Trưng
融辉=Dung Huy
霍布金斯=Hopkins
唐先礼=Đường Tiên Lễ
羽皇=Vũ Hoàng
段誉=Đoàn Dự
余羲=Dư Hi
畅乐=Sướng Nhạc
凯西=Casey
凌霄=Lăng Tiêu
木尺素=Mộc Xích Tố
林岳川=Lâm Nhạc Xuyên
子桃=Tử Đào
玛莉亚=Maria
黄神=Hoàng Thần
绿意=Lục Ý
鬼门关=Quỷ Môn quan
布缇娜=Buthayna
潘竞=Phan Cạnh
扎齐伊=Zaki
文轩=Văn Hiên
江一鸣=Giang Nhất Minh
刑语语=Hình Ngữ Ngữ
小幕=Tiểu Mạc
罗密欧=Romeo
小洛收=Tiểu Lạc Thu
西瓜 JUN=Tây Qua JUN
曲奇=Khúc Kỳ
小邪=Tiểu Tà
普瑞斯=Prius
一斗=Itto
九条=Kujou
乔诗语=Kiều Thi Ngữ
余辞=Dư Từ
赛诺=Cyno
陈皮阿四=Trần Bì A Tứ
炀神=Dương thần
小文=Tiểu Văn
裟罗=Sara
朱盘龙=Chu Bàn Long
飞花落雪=Phi Hoa Lạc Tuyết
褚碎璧=Chử Toái Bích
俞尧=Du Nghiêu
淮铭=Hoài Minh
北市=thành phố Bắc
腾蛇=Đằng Xà
总局=Tổng cục
祈神=Kỳ thần
傅善祥=Phó Thiện Tường
琴=Jean
行什=Hàng Thập
万钧=Vạn Quân
吴邪=Ngô Tà
唐纳滋=Donalds
竹青青=Trúc Thanh Thanh
度朔=Độ Sóc
心海=Tâm Hải
青莲宗=Thanh Liên tông
安晓文=An Hiểu Văn
小火=Tiểu Hỏa
安苏亚=Ansuya
陆生=Lục Sinh
格雷=Grey
卩恕=Tiết Thứ
绿水村=thôn Lục Thuỷ
沈度=Thẩm Độ
郁夜泊=Úc Dạ Bạc
北边雪女=Tuyết Nữ phương Bắc
小曹=Tiểu Tào
北辰君=Bắc Thần Quân
梧桐=Ngô Đồng
司南=Tư Nam
布莱诺斯=Blanos
巫山=Vu Sơn
风摇=Phong Dao
东藏=Đông Tàng
叶小贵=Diệp Tiểu Quý
黎簇=Lê Thốc
林雄贸=Lâm Hùng Mậu
房锐宝=Phòng Duệ Bảo
途途=Đồ Đồ
方微=Phương Vi
宋明哲=Tống Minh Triết
温德明=Ôn Đức Minh
苏晓蓉=Tô Hiểu Dung
小凯凯=Tiểu Khải Khải
大飞=Đại Phi
纳塔=Natlan
曲郁山=Khúc Úc Sơn
张瑾=Trương Cẩn
枫原万叶=Kaedehara Kazuha
太乙真人=Thái Ất chân nhân
魏空弘=Ngụy Không Hoằng
赵文彦=Triệu Văn Ngạn
徐敏慧=Từ Mẫn Tuệ
格尔彩尔=Gelzer
余海鲜=Dư Hải Sản
罗莎莉亚=Rosaria
王倩=Vương Thiến
高一泽=Cao Nhất Trạch
刘昌=Lưu Xương
利安=Ryan
寿鬼=Thọ Quỷ
桑赞=Tang Tán
沙多克里夫=Sutcliff
周天=Chu Thiên
雷昂=Leon
潘海生=Phan Hải Sinh
小钱=Tiểu Tiền
卫建涛=Vệ Kiến Đào
闻天衡=Văn Thiên Hoành
叶子寒=Diệp Tử Hàn
任修罗=Nhậm Tu La
埃洛伊=Aloy
杨超英=Dương Siêu Anh
提瓦特=Teyvat
鲍启文=Bào Khải Văn
文熙=Văn Hi
丫丫=Nha Nha
孟前程=Mạnh Tiền Trình
离稍微=Ly Sảo Vi
张生=Trương Sinh
长真=Trường Chân
萧伯纳=Shaw
朱凌=Chu Lăng
慕容枫=Mộ Dung Phong
赵小星=Triệu Tiểu Tinh
伊森=Y Sâm
阿尔法=Alfa
易江南=Dịch Giang Nam
诸怀=Chư Hoài
延福=Diên Phúc 
乔希=Kiều Hi
苏冰=Tô Băng
林轻羽=Lâm Khinh Vũ
爱琳=Irene
文武=Văn Võ
星星=Tinh Tinh
刘大河=Lưu Đại Hà
璃月七星=Thất tinh Liyue/Thất tinh Ly Nguyệt
安徒=Anders
苗苗=Miêu Miêu
斩魂刀=đao Trảm Hồn 
胡桃=Hutao/Hồ Đào
林敏芝=Lâm Mẫn Chi
九妹=Cửu Muội
行秋=Xingqiu/Hành Thu
德利克=Derick
陆征=Lục Chinh
邢芳芳=Hình Phương Phương
达雷斯=Dalles
周永玲=Chu Vĩnh Linh
神女劈观=Thần Nữ Phách Quan
长风路=đường Trường Phong
马格米兰=McMillan
哦漏=Nga Lậu
姜可可=Khương Khả Khả
鹿野院=Shikanoin
约翰=John
顾云舟=Cố Vân Chu
杰宝=Kiệt Bảo
唐少空=Đường Thiếu Không
优菈=Eula
商寅=Thương Dần
文森特=Vincent
英子=Anh Tử
张涵玉=Trương Hàm Ngọc
罗刹天=La Sát Thiên
萧润民=Tiêu Nhuận Dân
贝姬=Becky
青松=Thanh Tùng
陆离=Lục Ly
朱慧仙=Chu Tuệ Tiên
胖胖=Bàn Bàn
友全=Hữu Toàn
小龙=Tiểu Long
浩浩=Hạo Hạo
马克思=Marc
雷霆真君=Lôi Đình chân quân
黎铮=Lê Tranh
贝尔格曼=Bergmann
海尔顿=Helton
班尼特=Bennett
克劳尔=Clair/Claus/Kraul
王小恬=Vương Tiểu Điềm
迪亚斯=Diaz
卢娟=Lư Quyên
李光华=Lý Quang Hoa
青铜门=cửa Thanh Đồng
赫曼=Herman
阮伯灵=Nguyễn Bá Linh
陶一五=Đào Nhất Ngũ
言小识=Ngôn Tiểu Thức
桂英=Quế Anh
莲莲=Liên Liên
北北=Bắc Bắc
危雨=Nguy Vũ
阿尔卑斯=Alb
小染=Tiểu Nhiễm
肖越宁=Tiêu Việt Ninh
小菜=Tiểu Thái
汪永海=Uông Vĩnh Hải
静音咒=chú Tịnh Âm
安成=An Thành
小烈=Tiểu Liệt
默卡=Merka
双林=Song Lâm
荒泷=Arataki
浅知=Thiển Tri
高飞=Cao Phi
福尔摩撒=Phúc Nhĩ Ma Tát
猢狲=Hồ Tôn
黄石=Hoàng Thạch
草乌卑次=Thảo Ô Ti Thứ
高音扬=Cao Âm Dương
皮修=Bì Tu
启航=Khải Hàng
卜天祥=Bốc Thiên Tường
谢青青=Tạ Thanh Thanh
阮白洁=Nguyễn Bạch Khiết
奥黛丽=Audrey
博得立=Bác Đắc Lập
许久尊=Hứa Cửu Tôn
一鸣=Nhất Minh
小崔=Tiểu Thôi
黄峰=Hoàng Phong
祝红=Chúc Hồng
九千岁=Cửu Thiên Tuế
穆袁峰=Mục Viên Phong
莫陌=Mạc Mạch
任亮=Nhậm Lượng
柳明=Liễu Minh
莫娜=Mona
秦欢=Tần Hoan
郝曼罗=Hách Mạn La
司徒静=Ti Đồ Tĩnh
蓝启=Lam Khải
敖烈=Ngao Liệt
任重远=Nhậm Trọng Viễn
楞严=Lăng Nghiêm
安倍=Abe/An Bội
钟义=Chung Nghĩa
苏以安=Tô Dĩ An
衣飞石=Y Phi Thạch
王睿=Vương Duệ
陆寻=Lục Tầm
奕奕=Dịch Dịch
巴乌=Ba Ô
小州=Tiểu Châu
青莲山=Thanh Liên sơn
拉斯朋=Rathbone/Rasbon
从小明=Tòng Tiểu Minh
遗留者=Di Lưu Giả
靳风=Cận Phong
阮亭芳=Nguyễn Đình Phương
姜琳=Khương Lâm
卢晓燕=Lư Hiểu Yến
方夏=Phương Hạ
肖金=Tiêu Kim
万生众佛=Phật Vạn Sinh Chúng
小强=Tiểu Cường
余懃=Dư Cần
雷鸣鸟=Lôi Minh điểu
叶唯=Diệp Duy
别克=Buick
凡渡=Phàm Độ
秦海清=Tần Hải Thanh
双禧宫=cung Song Hi
邓文斌=Đặng Văn Bân
五郎=Gorou
法里斯=Faris
安安=An An
牛大壮=Ngưu Đại Tráng
蓝泽飞=Lam Trạch Phi
阿格雷斯=Agares
闻天和=Văn Thiên Hòa
路宁=Lộ Ninh
沃特=Ốc Đặc
渝州=Du Châu
温迪=Venti
巴拉特=Bharat
法尔达克=Fardak
川湘=Xuyên Tương
应辞=Ứng Từ
金鹏=Kim Bằng/Alatus
明辉=Minh Huy
吴一穷=Ngô Nhất Cùng
李琳=Lý Lâm
小丹=Tiểu Đan
项诚=Hạng Thành
梁永康=Lương Vĩnh Khang
排骨教主=Bài Cốt giáo chủ
小景=Tiểu Cảnh
邝泉=Quảng Tuyền
稻妻=Inazuma
刘姐=Lưu Tả
布鲁赫=Bluher
凝光=Ningguang/Ngưng Quang
晃岩=Wackelstein
沈舟=Thẩm Chu
北斗=Bắc Đẩu/Beidou
牧野洋洋=Mục Dã Dương Dương
鲜满宫堂=Tiên Mãn Cung Đường
眠眠=Miên Miên
玄诚子=Huyền Thành Tử
程欲雪=Trình Dục Tuyết
左擎苍=Tả Kình Thương
段小芸=Đoàn Tiểu Vân
张起灵=Trương Khởi Linh
费列罗=Ferrero
桑丘=Sancho
白玉堂=Bạch Ngọc Đường
夏淮铭=Hạ Hoài Minh
重云=Chongyun/Trùng Vân
毕泽泰=Tất Trạch Thái
齐格=Ziggy
周扬=Chu Dương
林华府=phủ Lâm Hoa
早柚=Sayu
闻天若=Văn Thiên Nhược
陈永=Trần Vĩnh
冈村=Okamura
阿识=A Thức
苏清风=Tô Thanh Phong
惊笑=Kinh Tiếu
崇明=Sùng Minh
孝敏后=Hiếu Mẫn hoàng hậu
小飞=Tiểu Phi
幕府=Shogunate/Bakufu
黑夜叉=Hắc Dạ Xoa
柯羽珩=Kha Vũ Hành
小刘=Tiểu Lưu
温玉=Ôn Ngọc
罗布拉禁术=cấm thuật La Bố Lạp
贺小旭=Hạ Tiểu Húc
袁牧=Viên Mục
苏青=Tô Thanh
毕元宾=Tất Nguyên Tân
池明远=Trì Minh Viễn
曹秋=Tào Thu
费尔罗=Ferro
陆萌=Lục Manh
霍修珣=Hoắc Tu Tuần
语语=Ngữ Ngữ
理水叠山真君=Lý Thuỷ Điệp Sơn chân quân
宵宮=Yoimiya
西风骑士团=Đội kỵ sĩ Tây Phong
顾风=Cố Phong
珠珠=Châu Châu
赵书彤=Triệu Thư Đồng
原慕=Nguyên Mộ
旭平=Húc Bình
周玉芳=Chu Ngọc Phương
宋显=Tống Hiển
移霄导天真君=Di Tiêu Đạo Thiên chân quân
余鑫隆=Dư Hâm Long
小芸=Tiểu Vân
富野=Tomino
顾江珩=Cố Giang Hành
世爵=Spyker
苏云菲=Tô Vân Phỉ
沈维希=Thẩm Duy Hy
张兰亭=Trương Lan đình
三千风雪=Tam Thiên Phong Tuyết
王魁=Vương Khôi
平不管=Bình Bất Quản
陆司语=Lục Tư Ngữ
商周=Thương Chu
小巫山=Tiểu Vu
九阴聚煞=Cửu Âm Tụ Sát
澳海=Úc Hải
麒麟正传=Kỳ Lân Chính Truyện
山海笔录=Bút lục Sơn Hải
东岳=Đông Nhạc
希思罗=Heathrow
钟离=Zhongli/Chung Ly
傅临江=Phó Lâm Giang
季卫国=Quý Vệ Quốc
陈三=Trần Tam
秦娴君=Tần Nhàn Quân
珠衡=Châu Hoành
董婉=Đổng Uyển
楚冬=Sở Đông
阿格尼=Agni
法图娜=Fatuna
小洛=Tiểu Lạc
枫原=Kaedehara
徐莹婉=Từ Oánh Uyển
将进酒=Thương Tiến Tửu
都市异闻录=Đô Thị Dị Văn Lục
慧寂=Tuệ Tịch
小绿=Tiểu Lục
朱朗=Chu Lãng
浮舍=Phù Xá/Bosacius
陈晓莎=Trần Hiểu Toa
张文成=Trương Văn Thành
顾艳=Cố Diễm
钊钊=Chiêu Chiêu
法尔伽=Varka
苏禄=Tô Lộc
中欧=Trung Âu
张卓=Trương Trác
妍世宝=Nghiên Thế Bảo
柯廷荣=Kha Đình Vinh
罗莎琳=Rosalyne
潘浚=Phan Tuấn
墨舞=Mặc Vũ
妮娜=Nina
包拯=Bao Chửng
宋雅=Tống Nhã
陈真=Trần Chân
振荣=Chấn Vinh
谢鹤=Tạ Hạc
范哲轩=Phạm Triết Hiên
小慈=Tiểu Từ
宁不问=Ninh Bất Vấn
西奈=Sin Al
阳天明=Dương Thiên Minh
艾瑞=Avery
王梓涵=Vương Tử Hàm
萧淮=Tiêu Hoài
埃塞尔=Ethel
迪奥娜=Diona
凯欧陆克=Georg
卢飞尔=Ruffer
绫人=Ayato
八重神子=Yae Miko
伊西斯=Isis
夕晨=Tịch Thần
阿特=Adel
刘方圆=Lưu Phương Viên
离原=Ly Nguyên
崔志峰=Thôi Chí Phong
伊安珊=Iansan
江江=Giang Giang
劳尔多=Paul
猫熊基金=quỹ Gấu Mèo
甘雨=Ganyu/Cam Vũ
封淮=Phong Hoài
潘开=Phan Khai
张小朵=Trương Tiểu Đóa
太阴真君=Thái Âm chân quân
陈元良=Trần Nguyên Lương
盖斯=Qais
狮魔兽=Sư Ma Thú
钟慧璐=Chung Tuệ Lộ
洛毅=Lạc Nghị
内维斯=Nevis/Neves
阿尔图=Arzu
徐小娟=Từ Tiểu Quyên
季夏=Quý Hạ
沈箐疏=Thẩm Thiến Sơ
云也=Vân Dã
赵云澜=Triệu Vân Lan
廖芳=Liêu Phương
蕊蕊=Nhụy Nhụy
奈布哈尼=Nabhani
樟木=Chương Mộc
镜面人=Kính Diện Nhân
宋阳=Tống Dương
迪卢克=Diluc
小胖龙=Tiểu Bàn Long
古利斯=Gullis
红莲鹤=Hồng Liên hạc
朱孝=Chu Hiếu
詹姆斯=James
马里奥=Mario
白幕=Bạch Mạc
沃河=Ốc Hà
晴明=Seimei/Tình Minh
昆吾=Kunwu/Côn Ngô
姬行=Cơ Hành
费加罗=Figaro
法兰西斯=Francis
梁静茹=Lương Tịnh Như
见酒=Kiến Tửu
萧何愁=Tiêu Hà Sầu
凡多姆海威=Phantomhive
朱希雅=Chu Hi Nhã
陆江=Lục Giang
陆丹=Lục Đan
大山沟=Đại Sơn Câu
左廷=Tả Đình
宋睿=Tống Duệ
黑袍使=Hắc Bào sứ
畹畹=Uyển Uyển
裴临=Bùi Lâm
欧阳轩=Âu Dương Hiên
小玉=Tiểu Ngọc
新波=Tân Ba
明哲=Minh Triết
文思雨=Văn Tư Vũ
张海客=Trương Hải Khách
房卒=Phòng Tốt
苏眠=Tô Miên
张梁=Trương Lương
顾燕=Cố Yến
陈国=Trần Quốc
温妮莎=Vannessa
须尽欢=Tu Tẫn Hoan
苏建刚=Tô Kiến Cương
孔晶=Khổng Tinh
朱芳=Chu Phương
白林=Bạch Lâm
翟鹏=Địch Bằng
董秦=Đổng Tần
钟睿=Chung Duệ
林凌=Lâm Lăng
楚歌=Sở Ca
白楚酒=Bạch Sở Tửu
牟德=Mâu Đức
李晓玉=Lý Hiểu Ngọc
元恺=Nguyên Khải
林言肃=Lâm Ngôn Túc
裴清=Bùi Thanh
李玉=Lý Ngọc
姜雨珊=Khương Vũ San
曹范=Tào Phạm
盛闻=Thịnh Văn
潘子=Phan Tử
画皮姑娘=Họa Bì cô nương
子玉=Tử Ngọc
杨美=Dương Mỹ
李子玉=Lý Tử Ngọc
罗小黑=La Tiểu Hắc
史皮尔斯=Spears
海先=Hải Tiên
山田=Yamada
迪兰斯=Dylans
顾旭平=Cố Húc Bình
方豪=Phương Hào
流焰=Lưu Diễm
牛娃=Ngưu Oa
铁树地狱=Thiết Thụ Địa Ngục
南十字=Nam Thập Tự
小林=Tiểu Lâm
小泰=Tiểu Thái
小宇=Tiểu Vũ
赫连东惠=Hách Liên Đông Huệ
宁幻=Ninh Huyễn
长发公主=Rapunzel
许含光=Hứa Hàm Quang
芭芭拉=Barbara
曹安=Tào An
林子安=Lâm Tử An
台庆=Đài Khánh
唐星光=Đường Tinh Quang
倪海星=Nghê Hải Tinh
弥怒=Di Nộ/Menogias
莫玉琼=Mạc Ngọc Quỳnh
严柯=Nghiêm Kha
贤之助=Kenosuke
阳晖=Dương Huy
李友德=Lý Hữu Đức
田明心=Điền Minh Tâm
刘韵卓=Lưu Vận Trác
小山=Tiểu Sơn
谭林=Đàm Lâm
晋海=Tấn Hải
谢行吟=Tạ Hành Ngâm
玄阳子=Huyền Dương Tử
凯尔文=Kelvin
小岳=Tiểu Nhạc
苏振荣=Tô Chấn Vinh
百长=Bách Trường
朱娜=Junah
陈凯=Trần Khải
郑云戚=Trịnh Vân Thích
林念恩=Lâm Niệm Ân
二毛=Nhị Mao
肖文武=Tiêu Văn Vũ
幽冥鬼姥=U Minh Quỷ Mẫu
刘宛=Lưu Uyển
绫华=Ayaka
中常侍=Trung Bình hầu
韩修杰=Hàn Tu Kiệt
罗丘=La Khâu
倭=Nhật Bản
五羊=Ngũ Dương
小护=Tiểu Hộ
单竺=Thiện Trúc
小氤=Tiểu Nhân
周媛=Chu Viện
史托卡=Stoker
史蒂夫=Steve
陈鹤宁=Trần Hạc Ninh
顾扬=Cố Dương
小屈=Tiểu Khuất
菲尔德斯=Fildes
刑天佑=Hình Thiên Hữu
爱玛士=Hermes
唐果=Đường Quả
林家俊=Lâm Gia Tuấn
赫本=Hepburn
双喜=Song Hỉ
觉坚=Giác Kiên
溪溪=Khê Khê
洛九原=Lạc Cửu Nguyên
陈惠=Trần Huệ
清韵小尸=Thanh Vận Tiểu Thi
无名=Vô Danh
曹信植=Tào Tín Thực
谢臻=Tạ Trăn
罗洪=La Hồng
腾宇=Đằng Vũ
小云=Tiểu Vân
吴山居=Ngô Sơn cư
蔡伦雅=Thái Luân Nhã
黑瞎子=Hắc Hạt Tử
江沅=Giang Nguyên
小晖=Tiểu Huy
杨嘉=Dương Gia
北麓=Bắc Lộc
孙珪=Tôn Khuê
徐华=Từ Hoa
胖子=Bàn Tử
郑川川=Trịnh Xuyên Xuyên
艾德嘉=Edgar
宝拉=Paula
蒋音=Tưởng Âm
温白=Ôn Bạch
苏缺=Tô Khuyết
马爹利=Martell
郭维维=Quách Duy Duy
妖精志异=Yêu Tinh Chí Dị
陌路柔情=Mạch Lộ Nhu Tình
贺云翔=Hạ Vân Tường
菲尔佩斯=Phelps
安不理=An Bất Lý
孙影=Tôn Ảnh
曹晓峰=Tào Hiểu Phong
珊瑚宮心海=Sangonomiya Kokomi
金敏娴=Kim Mẫn Nhàn
万永浩=Vạn Vĩnh Hạo
小昭=Tiểu Chiêu
苏木=Tô Mộc
陆静=Lục Tĩnh
江英俊=Giang Anh Tuấn
折枝=Chiết Chi
张文良=Trương Văn Lương
天水派=phái Thiên Thuỷ
泰戈尔=Tagore
柳月=Liễu Nguyệt
大陶=Đại Đào
许子越=Hứa Tử Việt
旭旭=Húc Húc
李程=Lý Trình
第三人民医院=Bệnh viện Nhân Dân số 3
宋华=Tống Hoa
撒贝宁=Táp Bối Ninh
阿沉=A Trầm
单云青=Đan Vân Thanh
小光=Tiểu Quang
王勃=Vương Bột
江航区=quận Giang Hàng
伪装学渣=Ngụy Trang Học Tra
陆刊=Lục San
陈元亮=Trần Nguyên Lượng
海棠路=đường Hải Đường
季尧=Quý Nghiêu
青鸟=Thanh Điểu
阿里木=Alim
吴文山=Ngô Văn Sơn
莫贝宁=Mạc Bối Ninh
乔萌萌=Kiều Manh Manh
小远=Tiểu Viễn
空对月=Không Đối Nguyệt
四喜=Tứ Hỉ
李佳=Lý Giai
青鹭=Thanh Lộ
林妹妹=Lâm muội muội/Lâm Đại Ngọc
坎瑞亚=Khaenri'ah
瑶瑶=Yaoyao/Dao Dao
醉梦星河=Túy Mộng Tinh Hà
阿曼德=Armand
严嵩=Nghiêm Tung
长岭=Trường Lĩnh
爱德华=Edward
叶溪年=Diệp Khê Niên
林修然=Lâm Tu Nhiên
格斯塔=Gestalt
黑白剑妖=Hắc Bạch Kiếm Yêu
散兵=Scaramouche
苏熠=Tô Tập
邱晚=Khâu Vãn
傅沉俞=Phó Trầm Du
段费老师=thầy Đoàn Phí
柯林瑞=Kha Lâm Thụy
洛贝尔=Lorbeer
杨秀清=Dương Tú Thanh
庄禛=Trang Chân
温桂云=Ôn Quế Vân
王珉豪=Vương Mân Hào
奥兰治=Orange
菲莱=Philae
芮尔=Riel
魔道祖师=Ma Đạo Tổ Sư
镜鬼=Kính Quỷ
滨江路=đường Tân Giang
彤彤=Đồng Đồng
卓礼=Trác Lễ
江奉=Giang Phụng
小白=Tiểu Bạch
霍秀秀=Hoắc Tú Tú
梅疏彤=Mai Sơ Đồng
田中=Takana
坎肩=Khảm Kiên
凯文=Kevin/Khải Văn
小江=Tiểu Giang
黑暗之主=Chúa tể Bóng tối
马游=Mã Du
贾马尔=Jamal
小阮=Tiểu Nguyễn
晋城=Tấn Thành
关承泽=Quan Thừa Trạch
道格=Doug
阿特雷德=Adelaide
可达=Kodak
夏鸥=Hạ Âu
赵启明=Triệu Khải Minh
白芷=Bạch Chỉ
临空=Lâm Không
周贺=Chu Hạ
小蓝=Tiểu Lam
文多多=Văn Đa Đa
刘国郁=Lưu Quốc Úc
鸣鸣=Minh Minh
八重=Yae
张凌瑄=Trương Lăng Tuyên
吕修阳=Lữ Tu Dương
埃博拉=Ebola
单童军=Thiện Đồng Quân
埃米利奥=Emilio
山河锥=Sơn Hà trùy
普立兹=Prydz
西鼎=Tây Đỉnh
莫得=Mạc Đắc
赵志明=Triệu Chí Minh
格根托如勒=Grento
权绎=Quyền Dịch
钱帕=Chambers
武重奉=Vũ Trọng Phụng
食人姬=Kuhime
郭长城=Quách Trường Thành
卜那那=Bốc Na Na
雷电将军=Raiden Shogun
杨胜兰=Dương Thắng Lan
璃月=Liyue/Ly Nguyệt
吴筱=Ngô Tiêu
美特斯邦威=Metersbonwe
巴特莱特=Bartlett
楚干将=Sở Can Tướng
何曦=Hà Hi
泰班=Thái Ban
谢涯=Tạ Nhai
万叶=Kazuha
梁山=Lương Sơn
三水=Tam Thuỷ
陆六=Lục Lục
天真无邪=Thiên Chân Vô Tà
鸣鸿=Minh Hồng
莫默=Mạc Mặc
泠鸢=Linh Diên
沈伟杰=Thẩm Vỹ Kiệt
离初=Ly Sơ
赤元草=cỏ Xích Nguyên
穆纳塔=Murata
江佟=Giang Đông
蓝蓝=Lam Lam
曹晓辉=Tào Hiểu Huy
魏雪松=Ngụy Tuyết Tùng
莱艮芬德=Ragnvindr
梅亭芳=Mai Đình Phương
于明浩=Vu Minh Hạo
沈正德=Thẩm Chính Đức
小风=Tiểu Phong
阿萨尔=Asal
原皓玥=Nguyên Hạo Nguyệt
塞弥拉弥斯=Semiramis
流沙=Lưu Sa
凡凡=Phàm Phàm
马梦起=Mã Mộng Khởi
搜神记=Sưu Thần ký
醉梦楼=Túy Mộng lâu
曲当=Khúc Đương
余飞=Dư Phi
徐伟标=Từ Vĩ Tiêu
王一舟=Vương Nhất Chu
肖蕊=Tiêu Nhụy
吴三省=Ngô Tam Tỉnh
越章=Việt Chương
周乞=Chu Khất
莱卡=Laika
胖丁=Bàn Đinh
小七=Tiểu Thất
刘梓平=Lưu Tử Bình
宋璟=Tống Cảnh
楚恕之=Sở Thứ Chi
小易=Tiểu Dịch
江戚=Giang Thích
灌灌=Quán Quán
朱双林=Chu Song Lâm
豐緣=Phong Duyên
夏志成=Hạ Chí Thành
朱丽叶=Juliet
王静香=Vương Tịnh Hương
诅咒娃娃=Búp bê nguyền rủa
李大伟=Lý Đại Vĩ
包亚男=Bao Á Nam
两面佛=Phật Lưỡng Diện
极光=Cực Quang/Aurora
诺艾尔=Noelle
丽莎=Lisa
无双=Vô Song
菲尼安=Finnian/Finian
威廉=William
王辅仁=Vương Phụ Nhân
杨胜飞=Dương Thắng Phi
越昆仑=Việt Côn Luân
削月築阳真君=Tước Nguyệt Trúc Dương chân quân
齐云=Tề Vân
徐子翼=Từ Tử Dực
潘小河=Phan Tiểu Hà
陆小北=Lục Tiểu Bắc
董睿平=Đổng Duệ Bình
屠程钢=Đồ Trình Cương
李志明=Lý Chí Minh
红岩狮=Hồng Nham sư
肖琴=Tiêu Cầm
法拉杰=Faraj
安利=An Lợi
光就居=Quang Tựu Cư
湘西=Tương Tây
肖天=Tiêu Thiên
金海路=đường Kim Hải
小肖=Tiểu Tiêu
开开=Khai Khai
叶织=Diệp Chức
胡高越=Hồ Cao Việt
凯亚=Kaeya
俞云天=Du Vân Thiên
Epeus=Epeus
薛礼=Tiết Lễ
知非=Tri Phi
莫小由=Mạc Tiểu Từ
谢执=Tạ Chấp
亚顿=Arden
陆开瑞=Lục Khai Thụy
北野之森=Bắc Dã Chi Sâm
杨小戟=Dương Tiểu Kích
小奇=Tiểu Kỳ
小一=Tiểu Nhất
熊漆=Hùng Tất
段费=Đoàn Phí
梁濂=Lương Liêm
甄妮=Chân Ny
拉德斯基=Radetzky
洛马森=Lomason
章天华=Chương Thiên Hoa
虞采洁=Ngu Thái Khiết
梁实=Lương Thực
解雨臣=Giải Vũ Thần
梭哈=Stud
并蒂冰莲=Tịnh Đế Băng Liên
颜一天=Nhan Nhất Thiên
小苗=Tiểu Miêu
董云=Đổng Vân
针锋对决=Châm Phong Đối Quyết
邱绍祥=Khâu Thiệu Tường
柯羽璜=Kha Vũ Hoàng
韩城=Hàn Thành
静莲=Tịnh Liên
维希=Duy Hy
孔府=Khổng phủ
梵凯旋=Phạn Khải Toàn
小严=Tiểu Nghiêm
南南=Nam Nam
小塘=Tiểu Đường
咸宁宁=Hàm Ninh Ninh
任君芜=Nhậm Quân Vu
云云=Vân Vân
烟绯=Yanfei/Yên Phi
吉祥府=phủ Cát Tường
痴嗔本真=Si Sân Bổn Chân/Nguồn Gốc Si Giận
苏苏=Tô Tô
神里绫人=Kamisato Ayato
柒遥=Thất Dao
小庄=Tiểu Trang
莫朗清=Mạc Lãng Thanh
叶氤=Diệp Nhân
格雷尔=Grell
陈封=Trần Phong
格列姆史毕=Grimsby
宋志=Tống Chí
李乐=Lý Nhạc
飞头蛮=Hitouban
小哲=Tiểu Triết
鲁青=Lỗ Thanh
王宏宽=Vương Hồng Khoan
周浩天=Chu Hạo Thiên
罗开=La Khai
段知衍=Đoàn Tri Diễn
方临时=Phương Lâm Thời
詹姆斯巴尔杰=James Barger
欧阳晖=Âu Dương Huy
刘擎龙=Lưu Kình Long
格总=chủ tịch Grento
醉梦楼的=Túy Mộng lâu
艾伦=Alan/Alán/Allan/Allen/Alaine/Allyn/Alen/Alin/Alein
俞神=Du thần
玛希尔=Mahir
苏诺=Tô Nặc
小莲=Tiểu Liên
翎翎=Linh Linh
雪莱=Shelley
鹿野院平蔵=Shikanoin Heizou
沈修哲=Thẩm Tu Triết
查尔曼=Charman
得耳刻托=Derketo
张莹=Trương Oánh
梅西=Mecy
小九爷=Tiểu Cửu Gia
陆酉=Lục Dậu
孙常侍=Tôn Thường hầu
陶知越=Đào Tri Việt
池敬渊=Trì Kính Uyên
汇丰=Hối Phong
陆游=Lục Du
林括=Lâm Quát
黄四兔=Hoàng Tứ Thố
尼尔森=Nelson
廖宪=Liêu Hiến
项澈=Hạng Triệt
谢卿=Tạ Khanh
俊俊=Tuấn Tuấn
刘钊=Lưu Chiêu
长生=Trường Sinh
翁涅斯=Onnes
于若雨=Vu Nhược Vũ
满天星=Mãn Thiên Tinh
丁浩浩=Đinh Hạo Hạo
吴聊=Ngô Liêu
花圆为君醉=Hoa Viên Vi Quân Túy
诺亚=Noah
宁宁=Ninh Ninh
杨春花=Dương Xuân Hoa
古恩希尔德=Gunnhildr
苏丹=Sultan
常琦=Thường Kỳ
江子蹇=Giang Tử Kiển
菲里克斯=Felix
史建华=Sử Kiến Hoa
罗绮芬=La Ỷ Phân
芭堤雅=Pattaya
黎丽娟=Lê Lệ Quyên
桥姬=Hashihime
北角=Bắc Giác
食尸鬼老祖=Thực Thi Quỷ Lão Tổ
十八泥犁经=kinh Thập Bát Nê Lê
高晏=Cao Yến
长白=Trường Bạch
金陵十三钗=Kim Lăng Thập Tam Thoa
格里高利=Gregory
壹枚=Nhất Mai
林晚=Lâm Vãn
云浅知=Vân Thiển Tri
黑眼镜=Hắc Nhãn Kính
小凯=Tiểu Khải
霍尔=Hall
忘川风华录=Vong Xuyên Phong Hoa Lục
梁菲凡=Lương Phi Phàm
可莉=Klee
塞巴斯蒂安=Sebastian
肖宇=Tiêu Vũ
佩蒂=Patty
阿杀=A Sát
季灿=Quý Xán
杰雷米=Jeremy
梵伽罗=Phạn Già La
楚青=Sở Thanh
陈大民=Trần Đại Dân
韩冉=Hàn Nhiễm
戴因斯雷布=Dainsleif
白昊天=Bạch Hạo Thiên
沈玉灵=Thẩm Ngọc Linh
凯旋=Khải Toàn
小十一=Tiểu Thập Nhất
叶凛=Diệp Lẫm
茂三=Shigeru
严静=Nghiêm Tĩnh
伊丽莎白=Elisabeth
林溪=Lâm Khê
红霞=Hồng Hà
小沈=Tiểu Thẩm
小杰=Tiểu Kiệt
小胡子=Tiểu Hồ Tử
应达=Ứng Đạt/Indarias
关秋=Quan Thu
劳埃德=Lloyd
米凯利斯=Michaelis
阿舜=A Thuấn
巴尔杰=Barger
陆焚=Lục Phần
四风守护=Tứ Phong thủ hộ
建新=Kiến Tân
建京=Kiến Kinh
廖胖子=Liêu Mập
刘申=Lưu Thân
克拉伦斯=Clarence
愚人众=Fatui
蛋蛋=Đản Đản
刑芳芳=Hình Phương Phương
若雨=Nhược Vũ
泽州=Trạch Châu
谢小芳=Tạ Tiểu Phương
韦埔村=thôn Vi Bộ
查尔斯=Charles
林秋石=Lâm Thu Thạch
厉决=Lệ Quyết
宋以星=Tống Dĩ Tinh
黄中庸=Hoàng Trung Dung
唐北=Đường Bắc
老凯=lão Khải
朱凯文=Chu Khải Văn
克劳伦斯=Clarence
如来=Như Lai
沈建军=Thẩm Kiến Quân
青川=Thanh Xuyên
山水亭=đình Sơn Thuỷ
林尼=Lyney
小羽=Tiểu Vũ
罗湘=La Tương
方拾一=Phương Thập Nhất
德林=Đức Lâm
康德=Kant
唐芸=Đường Vân
应龙=Ứng Long
北辰族=tộc Bắc Thần
寒枝=Hàn Chi
野火杯=Dã Hỏa Bôi
楚松柏=Sở Tùng Bách
霍明海=Hoắc Minh Hải