巨蟹宫=cung Cự Giải/Cancer
伯克郡=Berkshire
脱欧=Brexit
毛里塔尼亚=Mauritania
仙后座=chòm sao Thiên Hậu/Cassiopeia 
麦席森=Mathison
英伦=England
玻利维亚=Bolivia
厄帕俄斯=Epeus/Epeius
法属圭亚那=Guyane thuộc Pháp
瓦波利切拉=Valpolicella
迪士尼=Disney
荷鲁斯=Horus
阿萨姆=Assam
厄瓜多尔=Ecuador
孽镜地狱=Địa Ngục Nghiệt Kính
沸沙地狱=Địa Ngục Phí Sa
澳大利亚=Australia/Úc
天燕座=chòm sao Thiên Yến/Apus
格林纳达=Grenada
南阿尔卑斯=Nam Alps
变城王=Biện Thành vương
纳兰性德=Nạp Lan Tính Đức
新世界=New World/Thế Giới Mới (phim)
太白=Thái Bạch/sao Kim/Venus
朱一龙=Chu Nhất Long
图瓦卢=Tuvalu
室女宫=cung Xử Nữ/Virgo
毕沙罗=Pissarro
诺福克岛=đảo Norfolk
泰国=Thái Lan/Thailand
日本=Nhật Bản
小米=Xiaomi
抚顺市=thành phố Phủ Thuận
利比里亚=Liberia
肯尼亚=Kenya
吉野家=Yoshinoya
阿Q正传=AQ Chính Truyện
磔刑地狱=Địa Ngục Trách Hình
江南=Giang Nam
哈尔滨市=thành phố Cáp Nhĩ Tân
吉普赛=Gypsy
天平座=chòm sao Thiên Bình/Libra
桑居都=Tang Cư Đô
大犬座=chòm sao Đại Khuyển/Canis Major
哪吒=Na Tra
黄帝内经=Hoàng Đế nội kinh
列傳=Liệt Truyện
埃塞俄比亚=Ethiopia
阿史那=A Sử Na
摩羯座=chòm sao Ma Kết/Capricornus
保加利亚=Bulgaria
贝多芬=Beethoven
塔希提=Tahiti
安提瓜=Antigua
帕蒂塔=Partita
达旦日追=(nữ tu viện) Rtags bstan ri khrod
巴巴多斯=Babados
铁树地狱=Địa Ngục Thiết Thụ
秦良玉=Tần Lương Ngọc/(nữ tướng thời Minh)
波兰=Ba Lan/Poland
巴布亚新几内亚=Papua New Guinea
马里=Mali
马其顿=Macedonia
瑞典=Thuỵ Điển/Sweden
双鱼宫=cung Song Ngư/Pisces
阿尔及利亚=Algeria
北马里亚纳群岛=quần đảo Bắc Mariana
北师大=Đại học Sư phạm Bắc Kinh
光就居=Quang Tựu Cư
居虚倅略=Cư Hư Thối Lược
笔塔=Tháp Bút
普罗米修斯=Prometheus
安徽=An Huy
淞沪市=thành phố Tùng Hỗ
孟加拉国=Bangladesh
长春市=thành phố Trường Xuân
天鹰座=chòm sao Thiên Ưng/Aquila
文殊菩薩=Văn Thù bồ tát
文庙=Văn miếu
土耳其=Thổ Nhĩ Kỳ/Turkey
泽西岛=Jersey
霍比特=Hobbit
尼加拉瓜=Nicaragua
岑猛=Sầm Mãnh
联合利华=Unilever
克利珀顿岛=đảo Clipperton
曾侯乙=Tăng Hầu Ất
比特币=Bitcoin
南宋=Nam Tống
武昌市=thành phố Vũ Xương
福克兰群岛=quần đảo Falkland
船底座=chòm sao Thuyền Để/Carina
纽约=New York
巴黎铁塔=tháp Effiel
杭州市=thành phố Hàng Châu
新西兰=New Zealand
瑞士=Thuỵ Sĩ/Switzerland
加尼福利亚=California
东京=Đông kinh/Tokyo
武仙座=chòm sao Vũ Tiên/Hercules
乌克兰=Ukraine
天蝎宫=cung Bò Cạp/Scorpio
蒙古=Mông Cổ/Mongolia
挖心地狱=Địa Ngục Oa Tâm
圣卢西亚岛=đảo Saint Lucia
寒水地狱=Địa Ngục Hàn Thuỷ
土库曼斯坦=Turkmenistan
昴日星官=Mão Nhật Tinh Quan
天兔座=chòm sao Thiên Thố/Lepus
威克岛=đảo Wake
阿鼻地狱=Địa Ngục A Tỳ
多明尼加共和国=Cộng hoà Doninican
湖南=Hồ Nam
时钟座=chòm sao Thời Chung/Horologium
地府=Địa Phủ
二十四史=Nhị Thập Tứ Sử
根西岛=Guernsey
安哥拉=Angola
颐和园=Di Hòa viên
百度地图=Baidu Map
约旦=Jordan
蓐收=Nhục Thu
乌兹别克斯坦=Uzbekistan
浙大=Đại học Chiết Giang
火烙地狱=Địa Ngục Hoả Lạc
计算机历史博物馆=Bảo tàng Lịch sử Máy tính
玄冥=Huyền Minh
杭州=Hàng Châu
龠兹=Dược Tư
塞内加尔=Senegal
塞舌尔群岛=Seychelles
昆仑=Côn Luân
几内亚=Guinea
后土=Hậu Thổ
扬州市=thành phố Dương Châu
重庆市=thành phố Trùng Khánh
特罗姆兰岛=đảo Tromelin
朱九妹=Chu Cửu Muội
莫桑比克=Mozambique
贝宁=Benin
挪威=Norway/Na Uy
廣州=Quảng Châu
天曹=Thiên Tào
横滨=Yokohama
冰山地狱=Địa Ngục Băng Sơn
开罗=Cairo
尼日尔=Niger
埃及=Ai Cập/Egypt
淘宝=Taobao
阿曼=Oman
鹿豹座=chòm sao Lộc Báo/Camelopar
天秤座=chòm sao Thiên Bình/Libra
宋帝王=Tống Đế vương
休杰克曼=Hugh Jackman
大势菩萨=Đại Thế bồ tát
扬州=Dương Châu
金陵=Kim Lăng
古埃及=Ai Cập cổ đại
宝瓶座=chòm sao Bảo Bình/Aquarius
马约特岛=đảo Mayotte
山羊座=chòm sao Sơn Dương/Capricornus
基林群岛=quần đảo Keeling
福建=Phúc Kiến
智械=Omnic/Intellitron
末都干直呼=Mạt Đô Can Trực Hô
许愿池=đài phun nước Trevi
四川=Tứ Xuyên
盾牌座=chòm sao Thuẫn Bài/Scuti UY
阿兰=Alan
烏滿=Ô Mãn
南三角座=chòm sao Nam Tam Giác/Triangulum Austale
偃师=Yển Sư
水浒=Thủy Hử
太平洋=Thái Bình dương
龟塔=Tháp Rùa
菲尔德斯半岛=bán đảo Fildes
沸屎地狱=Địa Ngục Phí Thỉ
西湖=Tây Hồ
清华大学=Đại học Thanh Hoa
海尔梅斯=Hermes
长庚=Trường Canh/sao Hôm/(là sao Kim)
卡戴珊=Kardashian
珊瑚海群岛=quần đảo Biển San Hô
伏羲=Phục Hi
博茨瓦纳=Botswana
西方鬼帝=Tây Phương quỷ đế
草烏卑次=Thảo Ô Ti Thứ
蒂阿瑙=Te Anau
乌鲁木齐=Ürümqi
宁波市=thành phố Ninh Ba
塔吉克斯坦=Tajikistan
安庆市=thành phố An Khánh
玫瑰玫瑰我爱你=Hoa hồng hoa hồng ta yêu người
船尾座=chòm sao Thuyền Vĩ/Puppis
阿尔巴尼亚=Albania
帕劳=Palau
长安大学=Đại học Trường An
马恩岛=đảo Mann
贾宝玉=Giả Bảo Ngọc
中山=Trung Sơn
玉夫座=chòm sao Ngọc Phu/Sculptor
南非=Nam Phi
铜雀台=Đài Đồng Tước
坦桑尼亚=Tanzania
阿斯旺=Aswan
吉布地=Djibouti
萨摩亚=Samoa
東嶽大帝=Đông Nhạc đại đế
爱尔兰=Ireland
处女座=chòm sao Xử Nữ/Virgo
塞尔维亚和黑山=Serbia và Montenegro
牙买加=Jamaica
剥皮地狱=Địa Ngục Bác Bì
珠峰=núi Chomolungma/núi Everest
披头士=The Beatles
魔兽世界=World of Warcraft
莲花手菩萨=Liên Hoa Thủ bồ tát
机械公敌=I, Robot
北阴大帝=Bắc Âm Đại Đế
普贤菩萨=Phổ Hiền bồ tát
伦敦眼=London Eye
万圣节=Halloween
扬马延岛=đảo Jan Mayen
新加坡=Singapore
蛆虫地狱=Địa Ngục Thư Trùng
大埃及博物馆=Grand Egyptian Museum
青岛=Thanh Đảo
津沽市=thành phố Tân Cô
参宿五=sao Tham Túc Ngũ/Bellatrix
委内瑞拉=Venezuela
夏尔巴=Sherpa
摩羯宫=cung Ma Kết/Capricorn
閻羅王=Diêm La vương
汉堡=Hamburg
多哥=Togo
俄罗斯=Nga/nước Nga/Russia
泰姬陵=Taj Mahal
山案座=chòm sao Sơn Án/Mensa
汉口市=thành phố Hán Khẩu
帝辛=Đế Tân
加拿大=Canada
芭提雅=Pattaya
牡羊座=chòm sao Mẫu Dương/Aries
墨西哥=Mexico
古巴=Cuba
新胡安岛=đảo Juan de Nova
天安门=Thiên An môn
阿拉伯联合酋长国=Các tiểu vương quốc Arab thống nhất/United Arab Emirates
东南=Đông Nam
华东师范大学=Đại học Sư phạm Hoa Đông
三角座=chòm sao Tam Giác/Triangulum
智利=Chile
安道尔=Andorra
阿曼尼=Armani
紫藤=Tử Đằng
南极洲=châu Nam Cực
马提尼克岛=đảo Martinique
山东=Sơn Đông
巨爵座=chòm sao Cự Tước/Crater
比利时巧克力=sô-cô-la Bỉ
尼泊尔=Nepal
茅台=Mao Đài
东方鬼帝=Đông Phương quỷ đế
枫丹白露=Fontainebleau
澳门特别行政区=đặc khu hành chính Macau
南冕座=chòm sao Nam Miện/Corona Australis
火山地狱=Địa Ngục Hoả Sơn
唐老鸭=vịt Donald
双子座=chòm sao Song Tử/Gemini
得克萨斯州=bang Texas
本溪市=thành phố Bổn Khê
令狐=Lệnh Hồ
斯洛伐克=Slovakia
阿瑟加德=Asgard
维瓦尔第=Vivaldi
诸圣节=Halloween
孟买=Mumbai
莫扎特=Mozart
阿根廷=Argentina
船帆座=chòm sao Thuyền Phàm/Vela
布基纳法索=Burkina Faso
小步舞曲=Minuet
阿布辛贝勒=Abu Simbel
左塞尔=Djoser
樓=Lâu
大连市=thành phố Đại Liên
孔雀座=chòm sao Khổng Tước/Pavo
南方鬼帝=Nam Phương quỷ đế
亚太地区=Châu Á Thái Bình Dương
霍兰思=Hà Lan/Holland
巴布达=Barbuda
乌拉圭=Uruguay
北京=Bắc Kinh
莱索托=Lesotho
斯巴达=Sparta
柏拉图=Platon
大不列顛及北愛爾蘭聯合王国=Vương quốc Liên hiệp Anh và Bắc Ireland
碧昂丝=Beyoncé
罗酆六天=La Phong Lục Thiên
天炉座=chòm sao Thiên Lô/Fornax
地球=Trái Đất/Địa Cầu
枉死地狱=Địa Ngục Uổng Tử
大熊座=chòm sao Đại Hùng/Ursa Major 
谅山=Lạng Sơn
圣多美和普林西比=Sao Tome và Principe
玉山词=đền Ngọc Sơn
寧瑪派=tông Nyingma/Cựu phái/Cổ mật/Hồng giáo
好望角=mũi Hảo Vọng
南大=Đại học Nam Kinh
麒麟座=chòm sao Kỳ Lân/Monoceros
狐狸座=chòm sao Hồ Ly/Vulpecula
玛丽苏=Mary Sue
陈莫=Trần Mạc
缅甸=Burma/Miến Điện
天钿女命=Ame-no-Uzume-no-Mikoto/Thiên Điền Nữ Mệnh
上海市=thành phố Thượng Hải
瓦利斯和富图纳群岛=quần đảo Wallis và Futuna
天鹤座=chòm sao Thiên Hạc/Grus
摩纳哥=Monaco
老挝=Lào
法国=Pháp
伊西斯=Isis
刀山地狱=Địa Ngục Đao Sơn
文莱=Brunei
西撒哈拉=Tây Saraha
罗盘座=chòm sao La Bàn/Pyxis
波尔干=Rotterdam
车裂地狱=Địa Ngục Xa Liệt
摩斯=Morse
轉輪王=Chuyển Luân vương
擂鼓墩=Lôi Cổ Đôn
东帝汶=Timor-Leste
法属波利尼西亚=Polynesia thuộc Pháp
墨尔本=Melbourne
日韩=Nhật Hàn
英属维尔京群岛=quần đảo Virgin thuộc Anh/British Virgin Islands
克罗=Quero
拔舌地狱=Địa Ngục Bạt Thiệt
巴林=Bahrain
图灵=Turing
百度百科=Baidu Baike
中德=Trung-Đức
栖旭桥=cầu Thê Húc
湾区=vùng vịnh San Francisco
雕具座=chòm sao Điêu Cụ/Caelum
铁册地狱=Địa Ngục Thiết Sách
科特迪瓦=Bờ Biển Ngà
泰晤士河=sông Thames
翰林院=viện Hàn Lâm
皮卡丘=Pikachu
武汉市=thành phố Vũ Hán
中央鬼帝=Trung Phương quỷ đế
斐济=Fiji
金瓶梅=Kim Bình Mai
荷属安的列斯=Antilles thuộc Hà Lan
奔驰=Mercedes-Benz
印度=Ấn Độ
北冕座=chòm sao Bắc Miện/Corona Borealis
史矛革=Smaug
飞鱼座=chòm sao Phi Ngư/Volans
双子宫=cung Song Tử/Gemini
孟菲斯=Memphis/Men-nefer
西安交通大学=Đại học Giao thông Tây An
人马座=chòm sao Nhân Mã/Sagittarius
无锡市=thành phố Vô Tích
烏略=Ô Lược
变成王=Biến Thành vương
葡萄牙=Bồ Đào Nha/Portugal
亚斯文=Aswan
凡尔赛=Versailles
哈尔滨工程大学=Đại học Kỹ thuật Cáp Nhĩ Tân
阎罗王=Diêm La Vương
喀麦隆=Cameroon
几内亚比绍=Guiné-Bissau
奥地利=Austria/Áo
罗马=La Mã
有梵高=Van Gogh
毛姆=Maugham
无间地狱=Địa Ngục Vô Gián
徐悲鸿=Từ Bi Hồng
巴赫=Bach
塞浦路斯=Cyprus
吉萨=Giza
东南大学=Đại học Đông Nam
英仙座=chòm sao Anh Tiên/Perseus
小马座=chòm sao Tiểu Mã/Equuleus
南京市=thành phố Nam Kinh
浙江=Chiết Giang
顺德区=quận Thuận Đức
薛定谔=Schrödinger
G大调小步舞曲=bản Minuet Sol trưởng/Minuet in G major
危地马拉=Guatemala
人物画报=Tạp chí Nhân vật
新世界城=Trung tâm thương mại phức hợp Tân Thế Giới/Trung tâm thương mại phức hợp New World
寒冰地狱=Địa Ngục Hàn Băng
巴菲特=W. Buffett
白宇=Bạch Vũ
红楼梦=Hồng Lâu Mộng
阮籍=Nguyễn Tịch
纽埃=Niue
兰州=Lan Châu
巴西=Brazil
马耳他=Malta
特拉法尔加=Trafalgar
牧夫座=chòm sao Mục Phu/Boötes/Arturus
英属印度洋领地=lãnh thổ Ấn Độ Dương thuộc Anh/British Indian Ocean Territory
枉死城=thành Uổng Tử
加蓬=Gabon
星巴克=Starbucks
科科瓦多=Corcovado
城关区=quận Thành Quan
捷克共和国=Cộng hoà Czech/Cộng hoà Séc
豺狼座=chòm sao Sài Lang/Lupus 
藏十王经=kinh Tạng Thập Vương
海地=Haiti
圭亚那=Guyana
曹雪芹=Tào Tuyết Cần
阿鲁巴岛=Aruba
奥迪r八=Audi R8
猎犬座=chòm sao Lạp Khuyển/Canes Venatici
室女座=chòm sao Xử Nữ/Virgo
蝘蜓座=chòm sao Yển Diên/Chamaeleon
科特兰=Cortland
阿塞拜疆=Azerbaijan
荀灌=Tuân Quán/(nữ tướng nhà Tấn)
D大调第四帕蒂塔=Partita IV cung Re trưởng/Partita IV in D Major
旅大市=thành phố Lữ Đại
天津=Thiên Tân
马绍尔群岛=quần đảo Marshall
蓝筹股=Blue chip
天津市=thành phố Thiên Tân
蒸笼地狱=Địa Ngục Chưng Lung
观自在菩萨=Quan Tự Tại bồ tát
林黛玉=Lâm Đại Ngọc
瓜德罗普岛=Guadeloupe
狮子座=chòm sao Sư Tử/Leo
扎克伯格=Zuckerberg
宝瓶宫=cung Bảo Bình/Aquarius
舂臼地狱=Địa Ngục Thung Cữu
也门=Yemen
巨蛇座=chòm sao Cự Xà/Serpens
泰山=Thái Sơn
半人马座=chòm sao Bán Nhân Mã/Centaurus
不盧半呼=Bất Lư Bán Hô
马拉维=Malawi
波江座=chòm sao Ba Giang/Eridanus
苍蝇座=chòm sao Thương Dăng/Musca
尼奥=Neot
转轮地狱=Địa Ngục Chuyển Luân
阿彌陀佛=Phật A Di Đà
烊铜地狱=Địa Ngục Dương Đồng
刚果民主共和国=Cộng hoà Dân chủ Congo
弗里曼特尔=Fremantle
巨蟹座=chòm sao Cự Giải/Cancer
南十字座=chòm sao Nam Thập Tự/Crux
雪龙号=tàu phá băng Rồng Tuyết
磨推地狱=Địa Ngục Ma Thôi
拉丁=Latin
苏丹=Sudan
仙王座=chòm sao Thiên Vương/Cepheus
天琴座=chòm sao Thiên Cầm/Lyra
文成公主=công chúa Văn Thành
华东=Hoa Đông
中非共和国=Cộng hoà Trung Phi
天箭座=chòm sao Thiên Tiễn/Sagitta
觀世音菩薩=Quan Thế Âm bồ tát
西南极=Tây Nam cực
陈世美=Trần Thế Mỹ
肥遗=Phì Di
敦煌=Đôn Hoàng
布隆迪=Burundi
蓬塔=Punta
匈牙利=Hungary
蒙特塞拉特=Montserrat
柬埔寨=Cambodia
刀锯地狱=Địa Ngục Đao Cứ
六分仪座=chòm sao Lục Phân Nghi/Sextans
硅谷=thung lũng Silicon
黄石公园=công viên Yellowstone
马来西亚=Malaysia
阿富汗=Afghanistan
梁紅玉=Lương Hồng Ngọc/(nữ tướng thời Nam Tống)
哥伦比亚=Columbia
孔子=Khổng Tử
德意志=Ðức/German
區通途=Khu Thông Đồ
皇后大道=đại lộ Queen
罗马教廷=giáo triều Romana
斯瓦尔巴群岛=quần đảo Svalbard
魔法少女=Maho Shojo
唐卡=Thangka
銅雀臺=Đài Đồng Tước
血池地狱=Địa Ngục Huyết Trì
杜鹃座=chòm sao Đỗ Quyên/Tucana
福楼拜=Flaubert
约顿海姆=Jötunheimr
草雉剑=thanh kiếm Kusanagi
陳莫=Trần Mạc
盘古=Bàn Cổ
顾贞观=Cố Trinh Quan
五猖神=Ngũ Xương thần
科科斯群岛=quần đảo Cocos
秘鲁=Peru
皮特凯恩群岛=quần đảo Pitcairn
灵枢=Linh Xu/Hoàng đế nội kinh - Linh Xu
噶举派=tông Kagyu/Dòng truyền miệng/Dòng truyền tai
伯利兹=Belize
居虛倅略=Cư Hư Thối Lược
牛坑地狱=Địa Ngục Ngưu Khanh
西安市=thành phố Tây An
卢旺达=Rwanda
北京师范大学=Đại học Sư phạm Bắc Kinh
宾夕法尼亚=Pennsylvania
辽金=Liêu Kim
绍兴=Thiệu Hưng
复旦大学=Đại học Phục Đán
施华洛世奇=Swarovski
常春藤校=Ivy League
长安=Trường An
长山=Trường Sơn
火车地狱=Địa Ngục Hoả Xa
奢比尸=Xa Bỉ Thi
所罗门群岛=quần đảo Solomon
锡兰=Ceylon
塞拉利昂=Sierra Leone
香江=Hồng Kông/Heung Kong
烧酒=Soju
列支敦士登=Liechtenstein
大本钟=tháp đồng hồ Big Ben/tháp đồng hồ Elizabeth
多伦多=Toronto
唧筒座=chòm sao Tức Đồng/Antlia
罗刹=La Sát
射手座=chòm sao Cung Thủ/Sagittarius
波斯尼亚和黑塞哥维那=Bosnia và Herzegovina
洪都拉斯=Honduras
共工=Cộng Công
南昌市=thành phố Nam Xương
矩尺座=chòm sao Củ Xích/Norma
天猫座=chòm sao Thiên Miêu/Lynx
北阴玄天=Bắc Âm Huyền Thiên
青島=Thanh Đảo
帝王谷=Thung lũng của các vị Vua
上海交大=Đại học Giao thông Thượng Hải
地藏王=Địa Tạng vương
哈德斯=Hades
西班牙=Tây Ban Nha
安提瓜和巴布达=Antigua và Barbuda
卢森堡=Luxembourg
锯解地狱=Địa Ngục Cứ Giải
独孤皇后=hoàng hậu Độc Cô 
美国=Hợp chúng quốc Hoa Kỳ/United State of America
迪拜=Dubai
南沙群岛=quần đảo Spratly
耶梦加德=Jörmungandr
卞城王=Biện Thành vương
犼=Hống
成都市=thành phố Thành Đô
宾夕法尼亚州=khối thịnh vượng chung Pennsylvania
日耳曼裔=Germanic
哥德巴赫=Goldbach
丘比特=Cupid
鲸鱼座=chòm sao Kình Ngư/Cetus
周公瑾=Chu Công Cẩn
泥犁地狱=Địa Ngục Nê Lê
御夫座=chòm sao Ngự Phu/Auriga
拉脱维亚=Latvia
平等王=Bình Đẳng vương
澳门=Macau
赞比亚=Zambia
摩洛哥=Morocco
米德加尔特=Midgard
克罗地亚=Croatia

狮子宫=cung Sư Tử/Leo
意大利=Italy
法尔曼=Valmont
马累=Malé
亚美尼亚=Armenia
补经地狱=Địa Ngục Bổ Kinh
青岛市=thành phố Thanh Đảo
画皮=Họa Bì
祝融=Chúc Dung
北方鬼帝=Bắc Phương quỷ đế
乐蜀=Luxor
地月=Trái Đất - Mặt Trăng
河内=Hà Nội
天鹅座=chòm sao Thiên Nga/Cygnus
拉萨=Lhasa
卡瓦劳=Kawarau
伊甸园=Eden
剑桥=Cambridge
斯洛文尼亚=Slovenia
阿蒙=Amun
伊朗=Iran
遍吉菩萨=Biến Cát bồ tát
格鲁派=tông Gelugpa/Tông của những hiền nhân/Phái mũ vàng
饕餮=Thao Thiết
感恩节=lễ Tạ Ơn
西安交大=Đại học Giao thông Tây An
启明=Khải Minh/sao Mai/(là sao Kim)
汤加=Tonga
施洗者约翰=John the Baptist
烛九阴=Chúc Cửu Âm
乍得=Chad
微信=WeChat
温莎=Windsor
沈阳市=thành phố Thẩm Dương
凯旋门=Khải Hoàn Môn
观音=Quan Âm
石涛=Thạch Đào/(nhà sư Phật giáo, thư pháp gia, họa sĩ phong cảnh đầu thời Thanh)
铜柱地狱=Địa Ngục Đồng Trụ
蝎虎座=chòm sao Hiết Hổ/Lacerta
文殊师利菩萨=Văn Thù Sư Lợi bồ tát
法罗群岛=quần đảo Faroe
北美=Bắc Mỹ
南大洋=Nam Đại Dương/Nam Băng Dương
立陶宛=Lithuania
北京大学=Đại học Bắc Kinh
金刚罗汉=Kim cương La hán
马尔代夫=Maldives
中国=Trung Quốc
瓦努阿图=Vanuatu
白俄罗斯=Belarus
過労死=Karoshi/Hiện tượng làm việc quá sức
武汉=Vũ Hán
卡拉马佐夫=Karamazov
国防科学技术大学=Đại học Công nghệ Quốc phòng Trung Quốc
冰岛=Iceland
句芒=Câu Mang
烏藉=Ô Tạ
秦始皇=Tần Thủy Hoàng
秦淮景=Tần Hoài cảnh/cảnh Tần Hoài
津巴布韦=Zimbabwe
西敏寺=điện Westminster
以色列=Israel
觀音菩薩=Quan Âm bồ tát
中美=Trung Mỹ
妙吉祥菩萨=Diệu Cát Tường bồ tát
烏呼=Ô Hô
科摩罗=Comoros
望远镜座=chòm sao Viễn Vọng Kính/Telescopium
仁川=Incheon
香港=Hồng Kông
沙特阿拉伯=Saudi Arabia
卡纳克=Karnak
中华=Trung Hoa
特立尼达和多巴哥=Trinidad và Tobago
京都市=thành phố Kinh Đô
河北=Hà Bắc
乌干达=Uganda
直布罗陀=Gilbratar
古龙水=Cologne
四面佛=Phật Tứ Diện
黑塞哥维那=Herzegovina
亡命天涯=The Fugitive/Kẻ Đào Tẩu (phim)
天鸽座=chòm sao Thiên Cáp/Columba
青衣神=Thanh Y thần
冰地狱=Địa Ngục Băng
威廉凡拿骚=William xứ Nassau
秦廣王=Tần Quảng vương
杜比=Dolby
乔治亚=Georgia
小狮座=chòm sao Tiểu Sư/Leo Minor
万里长城=Vạn Lý Trường Thành
芬尼根的守灵夜=Finnegans Wake
台湾=Đài Loan
碧螺春=Bích Loa Xuân
宝格丽=Bulgari
司徒=Tư Đồ
佛得角=Cape Verde
圣诞岛=đảo Giáng Sinh
丹麦=Đan Mạch
須健居=Tu Kiện Cư
宽客=Quants
人马宫=cung Nhân Mã/Sagittarius
嵇康=Kê Khang
镇国寺=chùa Trấn Quốc
巴亭广场=quảng trường Ba Đình
鲁米诺=Luminol
托克劳=Tokelau
清华=Thanh Hoa
强良=Cường Lương
圣基茨和尼维斯=Saint Kitts và Nevis
科威特=Kuwait
昆斯顿=Queenstown
三世佛=Phật Tam Thế
巴拉圭=Paraguay
萨默塞特=Somerset
格洛里厄斯群岛=quàn đảo Glorioso
桂西=Quế Tây
泰山王=Thái Sơn vương
伯克利=Berkeley
巴基斯坦=Pakistan
王聰兒=Vương Thông Nhi/(thủ lĩnh Bạch Liên giáo phản kháng nhà Thanh)
三侠五义=Tam hiệp Ngũ nghĩa
龙龟=Long Quy/Bá Hạ
萨卡拉=Saqqara
长蛇座=chòm sao Trường Xà/Hydra
蛇夫座=chòm sao Xà Phu/Ophiuchus
马达加斯加=Madagascar
西藏=Tây Tạng
毛里求斯=Mauritius
吉尔吉斯斯坦=Kyrgystan
纵目神=Tung Mục thần
鮑三娘=Bào Tam Nương/(vợ Quan Sách trong Tam Quốc diễn nghĩa)
赤道几内亚=Cộng hoà Guinea Xích Đạo
刀兵地狱=Địa Ngục Đao Binh
凯撒=Caesar
铁磨地狱=Địa Ngục Thiết Ma
特克斯和凯科斯群岛=quần đảo Turks và Caicos
不丹=Bhutan
历代帝王庙=Lịch đại Đế Vương miếu
卢克索=Luxor
黎巴嫩=Lebanon
卡塔尔=Qatar
亚尔夫海姆=Álfheim
中国人民解放军国防大学=Đại học Quốc phòng Trung Quốc/Đại học Quốc phòng Quân Giải phóng Nhân dân Trung Quốc
压石地狱=Địa Ngục Áp Thạch
梵蒂冈城=thành phố Vatican
阿芙洛狄=Aphrodite
烏竟都=Ô Cánh Đô
海豚座=chòm sao Hải Đồn/Delphinus
旧金山=San Francisco
圆规座=chòm sao Viên Qui/Circinus
德国=Đức
西安=Tây An
天狼星=sao Thiên Lang/Sirius
斯芬克斯=Sphinx
希腊=Hy Lạp
开曼群岛=quần đảo Caymman
巴哈马=Bahamas
卡农=Canon
斯里兰卡=Sri Lanka
萨尔瓦多=El Salvador
澳洲=Úc/Australia
天齊仁聖大帝=Thiên Tề Nhân Thánh đại đế
天吴=Thiên Ngô
新喀里多尼亚=New Caledonia
佰鲁提=Berluti
格陵兰=Greenland
欧美=Âu Mỹ
弥勒菩萨=Di Lặc bồ tát 
沙特=Saudi
图坦卡蒙=Tutankhamun
索马里=Somalia
上海滩=bến Thượng Hải
维尔京群岛=quần đảo Virgin
秦淮=Tần Hoài
南京=Nam Kinh
石磨地狱=Địa Ngục Thạch Ma
魔法师梅林=pháp sư Merlin
菲律宾=Philippines
上海新世界城=Trung tâm thương mại phức hợp Tân Thế Giới Thượng Hải/Trung tâm thương mại phức hợp Shanghai New World 
广西=Quảng Tây
帝江=Đế Giang
白羊宫=cung Bạch Dương/Aries
宾利=Bentley
利比亚=Libya
国家地理=National Geographic
纳瓦萨岛=đảo Navassa
伊丽莎白公主地=vùng đất của công chúa Elizabeth/Princess Elizabeth Land
水瓶座=chòm sao Thuỷ Bình/Aquarius
后发座=chòm sao Hậu Phát/Coma Berenices
韩国=Hàn Quốc
琐罗亚斯德=Zoroaster
长城=Trường Thành
天龙座=chòm sao Thiên Long/Draco
都盧難旦=Đô Lư Nan Đán
石濤=Thạch Đào/(nhà sư Phật giáo, thư pháp gia, họa sĩ phong cảnh đầu thời Thanh)
佛洛依德=Freud
仙女系=Andromeda
天蝎座=chòm sao Bò Cạp/Scorpius
魔都=Ma Đô/Thượng Hải
和合二仙=Hòa Hợp Nhị tiên
摩尔多瓦=Moldova
圣马力诺=San Marino
印度尼西亚=Indonesia
叙利亚=Syria
多米尼克=Dominica
豫园=Dự viên/vườn Dự
乌鸦座=chòm sao Ô Nha/Corvus
曼殊室利菩萨=Man Thù Thất Lợi bồ tát
瓦那卡=Wanaka
苏里南=Suriname
地狱=Địa Ngục
广东=Quảng Đông
百慕大=Bermuda
势至菩萨=Thế Chí bồ tát
豪斯登堡=Huis Ten Bosch
黑身地狱=Địa Ngục Hắc Thân
剪刀地狱=Địa Ngục Tiễn Đao
都市王=Đô Thị vương
五官王=Ngỗ Quan vương
松恩峡湾=Sognefjorden
斯威士兰=Swaziland
嘉靖=Gia Tĩnh
绘架座=chòm sao Hội Giá/Pictor
上海=Thượng Hải
圣皮埃尔和密克隆群岛=quần đảo Saint Pierre và Miquelon
巴蜀=Ba Thục/Tứ Xuyên
绝地求生=PUBG
楚江王=Sở Giang vương
哈尔滨=Cáp Nhĩ Tân
上海交通大学=Đại học Giao thông Thượng Hải
酆都大帝=Phong Đô đại đế
古螺城=thành Cổ Loa
天秤宫=cung Thiên Bình/Libra
北平市=thành phố Bắc Bình
泥盧都=Nê Lư Đô
D大调=D major
圣赫勒拿岛=đảo Saint Helena
东南极=Đông Nam Cực
江苏=Giang Tô
微博=Weibo
库克群岛=quần đảo Cook
北京市=thành phố Bắc Kinh
芬兰=Phần Lan
罗托鲁阿=Rotorua
密克罗尼西亚联邦=Liên bang Micronesia
小熊座=chòm sao Tiểu Hùng/Ursa Minor
匈奴=Hung Nô
库克=Tim Cook
南鱼座=chòm sao Nam Ngư/Piscis Austrinus
盖山地狱=Địa Ngục Cái Sơn
广州市=thành phố Quảng Châu
剑鱼座=chòm sao Kiếm Ngư/Dorado
得克萨斯=Texas
费奥多尔=Fyodor
薩迦派=tông Sakya/tông Đất xám
瑙鲁=Nauru
畜生地狱=Địa Ngục Súc Sinh
关岛=Guam
凤凰座=chòm sao Phượng Hoàng/Phoenix
纳米比亚=Namibia
乌得勒支=Utrecht
胡志明博物馆=bảo tàng Hồ Chí Minh
泽州=Trạch Châu
哥斯达黎加=Costa Rica
孔斯=Khonsu
南极=Nam Cực
大勢至菩薩=Đại Thế Chí bồ tát
伊拉克=Irag
姆特=Mut
英国=Vương quốc Anh/United Kingdom
冈比亚=Gambia
乔布斯=Steve Jobs
奥西里斯=Osiris
瓦力=WALL-E
欧罗巴岛=đảo Europa
水蛇座=chòm sao Thủy Xà/Hydrus
还剑湖=hồ Hoàn Kiếm
居虚=Cư Hư
鹿特丹=Rotterdam
南极座=chòm sao Nam Cực/Octans
陀思妥耶夫斯基=Dostoevsky
无畏舰=Dreadnought/Dreadnaught (battleship)
旱魃=Hạn Bạt
罗马尼亚=Romania
故宫=Cố Cung/Tử Cấm Thành
比利时=Belgium/Bỉ
谛听=Đế Thính
猎户座=chòm sao Thiên Long/Orion
巴黎=Paris
北大=Đại học Bắc Kinh
皇后镇=Queenstown
小犬座=chòm sao Tiểu Khuyển/Canis Minor
突尼斯=Tunisia
欧阳=Âu Dương
哈利法塔=Burj Khalifah
普希金=Pushkin
大英博物馆=bảo tàng Anh/The British Museum
腾讯=Tencent
西伯利亚=Siberia
佛山市=thành phố Phật Sơn
广西大学=Đại học Quảng Tây
诺依曼=Neumann
仙女座=chòm sao Tiên Nữ/Andromeda
铁床地狱=Địa Ngục Thiết Sàng
房卒=Phòng Tuất
圣文森特和格林纳丁斯=Saint Vincent và Grenadines
安圭拉岛=Anguilla
诺查丹玛斯=Nostradamus
白羊座=chòm sao Bạch Dương/Aries
油锅地狱=Địa Ngục Du Oa
尊盘=Tôn Bàn
摩诃婆罗多=Mahabharata
干将莫邪=Can Tương Mạc Tà
留尼汪=đảo Reunion
复旦=Phục Đán
波多黎各=Puerto Rico
爱沙尼亚=Estonia
飞马座=chòm sao Phi Mã/Pegasus
西沙群岛=quần đảo Paracel
利路亚=Hallelujah
金牛宫=cung Kim Ngưu/Taurus
突厥=Đột Quyết
三国演义=Tam Quốc Diễn Nghĩa
印第安座=chòm sao Ấn Đệ An/Indus
瓦卡蒂普=Wakatipu
胡志明=Hồ Chí Minh
波斯尼亚=Bosnia
巴拿马=Panama
赫菲斯托斯=Hephaestus
阎王=Diêm vương
朝鲜=Triều Tiên
荷兰=Hà Lan/Netherlands
越南=Việt Nam
尼日利亚=Nigeria
天坛座=chòm sao Thiên Đàn/Ara
美属萨摩亚=American Samoa
北阴酆都大帝=Bắc Âm Phong Đô đại đế
伦敦=London
普罗米西斯=Prometheus
刚果共和国=Cộng hoà Congo
碓舂地狱=Địa Ngục Đối Thung
梧州市=thành phố Ngô Châu
镬汤地狱=Địa Ngục Hoạch Thang
吴兆骞=Ngô Triệu Khiên
武漢=Vũ Hán
基里巴斯=Kiribati
网罟座=chòm sao Võng Cổ/Reticulum
加纳=Ghana
显微镜座=chòm sao Hiển Vi Kính/Microscopium
鞍山市=thành phố An Sơn
厄立特里亚=Eritrea
哈萨克斯坦=Kazakhstan
释迦牟尼=Thích Ca Mâu Ni
武大=Đại học Vũ Hán